007 James Bond	(Master System)
94 Super World Cup Soccer	(Master System)
A-Team, The Music	(Master System)
Ace of Aces	(Master System)
Action Fighter	(Master System)
Addams Family, The	(Master System)
Aerial Assault	(Master System)
After Burner	(Master System)
Air Rescue	(Master System)
Aladdin	(Master System)
Alex Kidd - BMX Trial	(Master System)
Alex Kidd - High Tech World	(Master System)
Alex Kidd - The Lost Stars	(Master System)
Alex Kidd in Miracle World	(Master System)
Alex Kidd in Shinobi World	(Master System)
ALF	(Master System)
Alibaba and 40 Thieves	(Master System)
Alien 3	(Master System)
Alien Storm	(Master System)
Alien Syndrome	(Master System)
Altered Beast	(Master System)
Andre Agassi Tennis	(Master System)
Arcade Smash Hits	(Master System)
Argos no Juujiken	(Master System)
Ariel - The Little Mermaid	(Master System)
Assault City	(Master System)
Asterix and the Great Rescue	(Master System)
Asterix and the Secret Mission	(Master System)
Asterix	(Master System)
Astro Warrior & Pit Pot	(Master System)
Astro Warrior	(Master System)
Ayrton Senna's Super Monaco GP II	(Master System)
Aztec Adventure - The Golden Road to Paradise	(Master System)
Back to the Future Part II	(Master System)
Back to the Future Part III	(Master System)
Baku Baku Animals	(Master System)
Bank Panic	(Master System)
Basket Ball Nightmare	(Master System)
Batman Returns	(Master System)
Battle Out Run	(Master System)
Battlemaniacs	(Master System)
Berlin no Kabe	(Master System)
Black Belt	(Master System)
Black Onyx, The	(Master System)
Blade Eagle 3D	(Master System)
Block Hole	(Master System)
Bobble Bobble	(Master System)
Bomb Jack	(Master System)
Bomber Raid	(Master System)
Bonanza Bros	(Master System)
Bonkers Wax Up!	(Master System)
Borderline	(Master System)
Bram Stoker's Dracula	(Master System)
Bubble Bobble	(Master System)
Buggy Run	(Master System)
C_So!	(Master System)
Cabbage Patch Kids	(Master System)
California Games II	(Master System)
California Games	(Master System)
Captain Silver	(Master System)
Casino Games	(Master System)
Castelo Ra Tin Bum	(Master System)
Castle of Illusion Starring Mickey Mouse	(Master System)
Castle, The	(Master System)
Chack'n Pop	(Master System)
Challenge Derby	(Master System)
Championship Lode Runner	(Master System)
Cheese Cat-astrophe with Speedy Gonzales	(Master System)
Choplifter (SG-1000)	(Master System)
Choplifter	(Master System)
Chuck Rock II - Son of Chuck	(Master System)
Chuck Rock	(Master System)
Circus Charlie	(Master System)
Cloud Master	(Master System)
Columns	(Master System)
Comic Bakery	(Master System)
Comical Machine Gun Joe	(Master System)
Complete Arcade Pack Collection, The	(Master System)
Congo Bongo	(Master System)
Cool Spot	(Master System)
Cosmic Spacehead	(Master System)
Cyber Shinobi, The	(Master System)
Cyborg Hunter	(Master System)
Cyborg Z	(Master System)
Daffy Duck in Hollywood	(Master System)
Dallyeora Pigu-Wang	(Master System)
Danan - The Jungle Fighter	(Master System)
Dead Angle	(Master System)
Deep Duck Trouble Starring Donald Duck	(Master System)
Defenders of Oasis - SMS Conversion	(Master System)
Desert Speedtrap - Starring Road Runner and Wile E. Coyote	(Master System)
Desert Strike	(Master System)
Dick Tracy	(Master System)
Dinobasher Starring Bignose the Caveman	(Master System)
Dinosaur Dooley, The	(Master System)
DiskCartGames	(Master System)
Doki Doki Penguin Land	(Master System)
Double Dragon	(Master System)
Double Hawk	(Master System)
Dr. HELLO	(Master System)
Dr. Robotnik's Mean Bean Machine	(Master System)
Dragon - The Bruce Lee Story	(Master System)
Dragon Crystal	(Master System)
Dragon Wang	(Master System)
Drol	(Master System)
Dynamite Duke	(Master System)
Dynamite Dux	(Master System)
Dynamite Headdy	(Master System)
E-SWAT - City Under Siege	(Master System)
E.I. - Exa Innova	(Master System)
Eagles 5	(Master System)
Earthworm Jim	(Master System)
Ecco the Dolphin - Tides of Time	(Master System)
Ecco the Dolphin	(Master System)
Elevator Action	(Master System)
Enduro Racer	(Master System)
Excellent Dizzy Collection, The	(Master System)
Exerion	(Master System)
FA Tetris	(Master System)
Fantastic Dizzy	(Master System)
Fantasy Zone - The Maze	(Master System)
Fantasy Zone II - The Tears of Opa-Opa	(Master System)
Fantasy Zone	(Master System)
Ferias Frustradas do Picapau	(Master System)
FIFA International Soccer	(Master System)
Fire & Forget II	(Master System)
Fire & Ice	(Master System)
Flash, The	(Master System)
Flashpoint	(Master System)
Flicky	(Master System)
Flintstones, The	(Master System)
Forgotten Worlds	(Master System)
Frogger	(Master System)
Fushigi no Oshiro Pit Pot	(Master System)
G-Loc Air Battle	(Master System)
Gaegujangi Kkachi	(Master System)
Gain Ground	(Master System)
Galactic Protector	(Master System)
Galaxian	(Master System)
Galaxy Force	(Master System)
GamesCart Collection	(Master System)
Gangster Town	(Master System)
Gauntlet	(Master System)
George Foreman's KO Boxing	(Master System)
Ghost House	(Master System)
Ghostbusters	(Master System)
Ghouls 'n Ghosts	(Master System)
Girl's Garden	(Master System)
Global Defense	(Master System)
Gold Miner-Cyco Bikes Collection	(Master System)
Golden Axe Warrior	(Master System)
Golden Axe	(Master System)
Golfamania	(Master System)
Golgo 13	(Master System)
Golvellius - Valley of Doom	(Master System)
GP Rider	(Master System)
GP World	(Master System)
Gulkave	(Master System)
Gun.Smoke	(Master System)
Guzzler	(Master System)
H.E.R.O.	(Master System)
Hang-On & Astro Warrior	(Master System)
Hang-On & Safari Hunt	(Master System)
Hang-On II	(Master System)
Hang-On	(Master System)
Heroes of the Lance	(Master System)
High School! Kimengumi	(Master System)
Home Alone	(Master System)
Home Mahjong	(Master System)
Hook	(Master System)
Hoshi wo Sagasite...	(Master System)
Hucal SC-3000	(Master System)
Hustle Chummy	(Master System)
Hyper Sports 2	(Master System)
Hyper Sports	(Master System)
Impossible Mission	(Master System)
Incredible Crash Dummies, The	(Master System)
Incredible Hulk, The	(Master System)
Indiana Jones and the Last Crusade	(Master System)
James 'Buster' Douglas Knockout Boxing	(Master System)
James Bond 007 - The Duel	(Master System)
James Pond II - Codename Robocod	(Master System)
Jang Pung 3	(Master System)
Janggun-ui Adeul	(Master System)
Joe Montana Football	(Master System)
Jungle Book, The	(Master System)
Jurassic Park	(Master System)
Kagaku (Gensokigou Master)	(Master System)
Kamikaze	(Master System)
Kenseiden	(Master System)
King & Balloon	(Master System)
King's Quest - Quest for the Crown	(Master System)
King's Valley	(Master System)
Klax	(Master System)
Knightmare II - The Maze of Galious	(Master System)
Krusty's Fun House	(Master System)
Kung Fu Kid	(Master System)
Land of Illusion Starring Mickey Mouse	(Master System)
Laser Ghost	(Master System)
Legend of Illusion Starring Mickey Mouse	(Master System)
Lemmings	(Master System)
Line of Fire	(Master System)
LinkWord	(Master System)
Lion King, The	(Master System)
Lode Runner	(Master System)
Loletta no Syouzou	(Master System)
Lord of the Sword	(Master System)
Loriciel's Z-80 Utilities Disk	(Master System)
Lucky Dime Caper, The - Starring Donald Duck	(Master System)
Magical Kid Wiz	(Master System)
Magical Tree	(Master System)
Mahjong Sengoku Jidai	(Master System)
Mahjong	(Master System)
Marble Madness	(Master System)
Marksman Shooting - Trap Shooting - Safari Hunt	(Master System)
Marksman Shooting - Trap Shooting	(Master System)
Master of Darkness	(Master System)
Masters of Combat	(Master System)
Maze Hunter 3D	(Master System)
Megumi Rescue	(Master System)
Mercs	(Master System)
Michael Jackson's Moonwalker	(Master System)
Mick & Mack as The Global Gladiators	(Master System)
Mickey's Ultimate Challenge	(Master System)
Micro Machines	(Master System)
Micro Xevious, The	(Master System)
Miracle Warriors - Seal of the Dark Lord	(Master System)
Missile Defense 3-D	(Master System)
Monaco GP	(Master System)
Monopoly	(Master System)
Montezuma's Revenge Featuring Panama Joe	(Master System)
Ms. Pac-Man	(Master System)
My Hero	(Master System)
N-Sub	(Master System)
Nekyuu Kousien	(Master System)
Nemesis	(Master System)
New Boggle Boggle	(Master System)
New Zealand Story, The	(Master System)
Nihonshi Nenpyou	(Master System)
Ninja Gaiden	(Master System)
Ninja Princess	(Master System)
Ninja, The	(Master System)
Olympiades	(Master System)
Olympic Gold	(Master System)
Operation Wolf	(Master System)
Orguss	(Master System)
Othello	(Master System)
Ottifants, The	(Master System)
OutRun 3D	(Master System)
OutRun Europa	(Master System)
OutRun	(Master System)
Pac-Man	(Master System)
Pac-Mania	(Master System)
Pacar	(Master System)
Pachinko II	(Master System)
Pachinko	(Master System)
Paperboy	(Master System)
Parlour Games	(Master System)
Pat Riley Basketball	(Master System)
Penguin Adventure	(Master System)
Penguin Land	(Master System)
Phantasy Star	(Master System)
Ping Pong (Konami's)	(Master System)
Pit Fighter	(Master System)
Pitfall II - The Lost Caverns	(Master System)
Pooyan	(Master System)
Pop Breaker	(Master System)
Pop Flamer	(Master System)
Populous	(Master System)
Poseidon Wars - Space Panic - Rambo	(Master System)
Poseidon Wars 3D	(Master System)
Power Boggle Boggle	(Master System)
Power Strike II	(Master System)
Power Strike	(Master System)
Predator 2	(Master System)
Prince of Persia	(Master System)
Pro Wrestling	(Master System)
Promocao Especial M.System III Compact	(Master System)
Psychic World	(Master System)
Psycho Fox	(Master System)
Putt & Putter	(Master System)
Puznic	(Master System)
Q-bert	(Master System)
Quartet	(Master System)
R-Type	(Master System)
R.C. Grand Prix	(Master System)
Rainbow Islands	(Master System)
Rambo - First Blood Part 2	(Master System)
Rambo III	(Master System)
Rampage	(Master System)
Rampart	(Master System)
Rastan	(Master System)
Ren & Stimpy - Quest for the Shaven Yak, The	(Master System)
Renegade	(Master System)
Rescue Mission	(Master System)
Road Rash	(Master System)
Robocop 3	(Master System)
Robocop versus The Terminator	(Master System)
Rock N' Bolt	(Master System)
Rocky	(Master System)
Running Battle	(Master System)
Safari Hunting	(Master System)
Safari Race	(Master System)
Sagaia	(Master System)
Samgukji III	(Master System)
San-Nin Mahjong	(Master System)
Satellite 7	(Master System)
Scramble Spirits	(Master System)
Sega Chess	(Master System)
Sega Flipper	(Master System)
Sega Galaga	(Master System)
SegaWord 3	(Master System)
Sekaishi Nenpyou	(Master System)
Sensible Soccer	(Master System)
Serizawa Hachidan no Tsumeshogi	(Master System)
Shadow Dancer - The Secret of Shinobi	(Master System)
Shadow of the Beast	(Master System)
Shanghai	(Master System)
Shinnyushain Tooru Kun	(Master System)
Shinobi	(Master System)
Shooting Gallery	(Master System)
Simpsons, The - Bart vs. the Space Mutants	(Master System)
Simpsons, The - Bart vs. the World	(Master System)
Sindbad Mystery	(Master System)
Sitio do Picapau Amarelo	(Master System)
Sky Jaguar	(Master System)
Slap Shot	(Master System)
Smurfs Travel the World, The	(Master System)
Smurfs, The	(Master System)
Solomon no Kagi - Oujo Rihita no Namida	(Master System)
Sonic Blast	(Master System)
Sonic Chaos	(Master System)
Sonic Spinball	(Master System)
Sonic The Hedgehog 2	(Master System)
Sonic The Hedgehog	(Master System)
Sonic's Edusoft	(Master System)
Soukoban	(Master System)
Space Armor	(Master System)
Space Gun	(Master System)
Space Harrier 3D	(Master System)
Space Harrier	(Master System)
Space Invaders	(Master System)
Space Mountain	(Master System)
Space Slalom	(Master System)
Special Criminal Investigation	(Master System)
Speedball 2	(Master System)
Speedball	(Master System)
Spellcaster	(Master System)
Spider-Man - Return of the Sinister Six	(Master System)
Spider-Man vs. the Kingpin	(Master System)
Spy vs. Spy	(Master System)
Star Force	(Master System)
Star Jacker	(Master System)
Star Wars	(Master System)
Street Fighter II'	(Master System)
Street Master	(Master System)
Streets of Rage II	(Master System)
Streets of Rage	(Master System)
Strider II	(Master System)
Strider	(Master System)
Submarine Attack	(Master System)
Suho Cheonsa	(Master System)
Sukeban Deka II - Shoujo Tekkamen Densetsu	(Master System)
Super Bubble Bobble	(Master System)
Super Jeux Yeno Examples	(Master System)
Super Kick Off	(Master System)
Super Monaco GP	(Master System)
Super Off-Road	(Master System)
Super Racing	(Master System)
Super Smash TV	(Master System)
Super Space Invaders	(Master System)
Super Tank	(Master System)
Superman	(Master System)
T2 - The Arcade Game	(Master System)
Taito Chase H.Q.	(Master System)
Taz in Escape From Mars	(Master System)
Taz-Mania	(Master System)
Teddy Boy	(Master System)
Tensai Bakabon	(Master System)
Terebi Oekaki	(Master System)
Terminator 2 - Judgment Day	(Master System)
Terminator, The	(Master System)
Three Dragon Story, The	(Master System)
Thunder Blade	(Master System)
Time Soldiers	(Master System)
Tom and Jerry - The Movie	(Master System)
Toto World 3	(Master System)
TransBot	(Master System)
Trivial Pursuit	(Master System)
Ultima IV - Quest of the Avatar	(Master System)
Ultimate Soccer	(Master System)
Uranai Angel Cutie	(Master System)
Vigilante	(Master System)
Virtua Fighter Animation	(Master System)
Wanted	(Master System)
Where in the World is Carmen Sandiego	(Master System)
Wimbledon II	(Master System)
Wimbledon	(Master System)
Wolf Child	(Master System)
Wonder Boy (SG-1000)	(Master System)
Wonder Boy III - The Dragon's Trap	(Master System)
Wonder Boy in Monster Land	(Master System)
Wonder Boy in Monster World	(Master System)
Wonder Boy	(Master System)
Wonsiin	(Master System)
Woody Pop - Shinjinrui no Block Kuzushi	(Master System)
WWF Wrestlemania Steel Cage Challenge	(Master System)
X-Men - Mojo World	(Master System)
Xenon 2	(Master System)
Xyzolog	(Master System)
Yamato	(Master System)
Yeno Draw	(Master System)
Yie Ar Kung-Fu	(Master System)
Ys - The Vanished Omens	(Master System)
Zaxxon 3-D	(Master System)
Zaxxon	(Master System)
Zillion II - The Tri Formation	(Master System)
Zillion	(Master System)
Zippy Race	(Master System)
Zool	(Master System)
Zoom 909	(Master System)
Aa Harimanada	(GameGear)
Addams Family, The	(GameGear)
Adventures of Batman & Robin, The	(GameGear)
Aerial Assault	(GameGear)
Aladdin	(GameGear)
Alien 3	(GameGear)
Alien Syndrome	(GameGear)
Andre Agassi Tennis	(GameGear)
Arcade Classics	(GameGear)
Arch Rivals	(GameGear)
Arena	(GameGear)
Ariel the Little Mermaid	(GameGear)
Arliel - Crystal Densetsu	(GameGear)
Asterix and the Great Rescue	(GameGear)
Ax Battler - A Legend of Golden Axe 	(GameGear)
Baku Baku Animal	(GameGear)
Barbie Super Model	(GameGear)
Bartman Meets Radioactive Man	(GameGear)
Batman Forever	(GameGear)
Batman Returns	(GameGear)
Batter Up	(GameGear)
Battleship	(GameGear)
Battletoads	(GameGear)
Battletoads	(GameGear)
Beavis and Butt-head (USA, Europe)	(GameGear)
Beavis and Butt-head	(GameGear)
Berenstain Bears' Camping Adventure, The	(GameGear)
Berlin no Kabe	(GameGear)
Bishoujo Senshi Sailor Moon S	(GameGear)
Bonkers Wax Up!	(GameGear)
Bram Stoker's Dracula	(GameGear)
Bubble Bobble	(GameGear)
Bugs Bunny in Double Trouble	(GameGear)
Bust-A-Move	(GameGear)
Buster Ball	(GameGear)
Buster Fight	(GameGear)
Caesars Palace	(GameGear)
Captain America and the Avengers	(GameGear)
Car Licence	(GameGear)
Casino Funpak	(GameGear)
Castle of Illusion Starring Mickey Mouse	(GameGear)
Chakan	(GameGear)
Chessmaster, The	(GameGear)
Chicago Syndicate	(GameGear)
Choplifter III	(GameGear)
Chuck Rock	(GameGear)
Chuck Rock II - Son of Chuck	(GameGear)
Cliffhanger	(GameGear)
Clutch Hitter	(GameGear)
Coca Cola Kid	(GameGear)
Columns	(GameGear)
Columns	(GameGear)
Cool Spot	(GameGear)
Cosmic Spacehead	(GameGear)
Crayon Shin-chan - Taiketsu! Kantam Panic!!	(GameGear)
Crystal Warriors	(GameGear)
Cutthroat Island	(GameGear)
Daffy Duck in Hollywood (Europe)	(GameGear)
Deep Duck Trouble Starring Donald Duck	(GameGear)
Defenders of Oasis	(GameGear)
Desert Speedtrap (Europe)	(GameGear)
Desert Speedtrap	(GameGear)
Desert Strike - Return to the Gulf	(GameGear)
Devilish	(GameGear)
Donald Duck no 4-Tsu no Hihou	(GameGear)
Donald Duck no Lucky Dime	(GameGear)
Donald no Magical World (Japan)	(GameGear)
Doraemon - Waku Waku Pocket Paradise	(GameGear)
Double Dragon	(GameGear)
Dr. Robotnik's Mean Bean Machine	(GameGear)
Dragon - The Bruce Lee Story	(GameGear)
Dragon Crystal	(GameGear)
Dragon Crystal - Tsurani no Meikyuu	(GameGear)
Dropzone	(GameGear)
Dunk Kids	(GameGear)
Dynamite Headdy	(GameGear)
Dynamite Headdy	(GameGear)
Earthworm Jim	(GameGear)
Ecco II - The Tides of Time	(GameGear)
Ecco the Dolphin	(GameGear)
Ecco the Dolphin II	(GameGear)
Eternal Legend - Eien no Densetsu	(GameGear)
Evander Holyfield Boxing	(GameGear)
Excellent Dizzy Collection, The	(GameGear)
F-15 Strike Eagle	(GameGear)
F1	(GameGear)
FIFA International Soccer	(GameGear)
Faceball 2000	(GameGear)
Factory Panic	(GameGear)
Fantastic Dizzy (Europe)	(GameGear)
Fantasy Zone Gear (USA, Europe)	(GameGear)
Fantasy Zone Gear	(GameGear)
Fatal Fury Special	(GameGear)
Foreman for Real	(GameGear)
Frank Thomas Big Hurt Baseball	(GameGear)
Fray - Shugyou Hen	(GameGear)
Frogger (USA)	(GameGear)
From TV Animation - Slam Dunk - Shouri e no Starting 5	(GameGear)
G-LOC Air Battle	(GameGear)
GG Aleste	(GameGear)
GG Doraemon - Noranosuke no Yabou	(GameGear)
GG Portrait - Pai Chen	(GameGear)
GG Portrait - Yuuki Akira	(GameGear)
GG Shinobi II, The - The Silent Fury	(GameGear)
GG Shinobi, The	(GameGear)
GP Rider	(GameGear)
Galaga '91	(GameGear)
Gamble Panic	(GameGear)
Gambler Jikochuushinha	(GameGear)
Ganbare Gorby!	(GameGear)
Garfield - Caught in the Act	(GameGear)
Garou Densetsu Special	(GameGear)
Gear Stadium	(GameGear)
Gear Stadium Heiseiban	(GameGear)
Gear Works	(GameGear)
George Foreman's KO Boxing	(GameGear)
Godzilla - Kaijuu Daishingeki	(GameGear)
Greendog	(GameGear)
Griffin	(GameGear)
Gunstar Heroes	(GameGear)
Halley Wars	(GameGear)
Halley Wars	(GameGear)
Head Buster	(GameGear)
Heavy Weight Champ	(GameGear)
Home Alone	(GameGear)
Honoo no Toukyuuji - Dodge Danpei	(GameGear)
Hook	(GameGear)
Hurricanes	(GameGear)
Hyokkori Hyoutan Jima - Hyoutan Jima no Daikoukai	(GameGear)
Hyper Pro Yakyuu '92	(GameGear)
Ichidant~R GG	(GameGear)
In the Wake of Vampire	(GameGear)
Incredible Crash Dummies, The	(GameGear)
Incredible Hulk, The	(GameGear)
Indiana Jones and the Last Crusade	(GameGear)
Iron Man X-O Manowar in Heavy Metal	(GameGear)
Itchy & Scratchy Game, The	(GameGear)
James Bond 007 - The Duel	(GameGear)
James Pond 3 - Operation Starfi5h	(GameGear)
James Pond II - Codename RoboCod	(GameGear)
Jeopardy!	(GameGear)
Journey from Darkness - Strider Returns	(GameGear)
Judge Dredd	(GameGear)
Junction	(GameGear)
Jungle Book, The	(GameGear)
Jurassic Park	(GameGear)
Kaitou Saint Tale	(GameGear)
Kawasaki Superbike Challenge	(GameGear)
Kenyuu Densetsu Yaiba	(GameGear)
Kick & Rush	(GameGear)
Kinetic Connection	(GameGear)
Kishin Douji Zenki	(GameGear)
Klax	(GameGear)
Krusty's Fun House	(GameGear)
Kuni-chan no Game Tengoku	(GameGear)
Kuni-chan no Game Tengoku Part 2	(GameGear)
Land of Illusion Starring Mickey Mouse	(GameGear)
Last Action Hero	(GameGear)
Legend of Illusion Starring Mickey Mouse	(GameGear)
Lemmings	(GameGear)
Lion King, The	(GameGear)
Lost World, The - Jurassic Park	(GameGear)
Lucky Dime Caper, The	(GameGear)
Lunar - Sanposuru Gakuen	(GameGear)
MLBPA Baseball	(GameGear)
Madden NFL '95	(GameGear)
Madden NFL '96	(GameGear)
Madou Monogatari A - Dokidoki Vacation	(GameGear)
Madou Monogatari I - 3-Tsu no Madoukyuu	(GameGear)
Madou Monogatari II - Arle 16-Sai	(GameGear)
Madou Monogatari III - Kyuukyoku Joou-sama	(GameGear)
Magic Knight Rayearth	(GameGear)
Magic Knight Rayearth 2 - Making of Magic Knight	(GameGear)
Magical Puzzle Popils (World)	(GameGear)
Magical Taruruuto-kun	(GameGear)
Majors Pro Baseball, The	(GameGear)
Mappy	(GameGear)
Marble Madness	(GameGear)
Mega Man	(GameGear)
Megami Tensei Gaiden - Last Bible	(GameGear)
Megami Tensei Gaiden - Last Bible S	(GameGear)
Mick & Mack as the Global Gladiators	(GameGear)
Mickey Mouse Densetsu no Oukoku - Legend of Illusion	(GameGear)
Mickey Mouse no Castle Illusion	(GameGear)
Mickey Mouse no Mahou no Crystal	(GameGear)
Mickey's Ultimate Challenge	(GameGear)
Micro Machines	(GameGear)
Micro Machines 2 - Turbo Tournament	(GameGear)
Mighty Morphin Power Rangers	(GameGear)
Mighty Morphin Power Rangers - The Movie	(GameGear)
Moldorian - Hikari to Yami no Sister	(GameGear)
Monster Truck Wars	(GameGear)
Monster World II - Dragon no Wana	(GameGear)
Mortal Kombat 	(GameGear)
Mortal Kombat 3	(GameGear)
Mortal Kombat II	(GameGear)
Ms. Pac-Man	(GameGear)
NBA Action	(GameGear)
Nazo Puyo	(GameGear)
Nazo Puyo 2	(GameGear)
Nazo Puyo Arle no Roux	(GameGear)
Neko Daisuki!	(GameGear)
Ninja Gaiden	(GameGear)
Ninja Gaiden	(GameGear)
Ninku	(GameGear)
Ninku 2 - Tenkuuryuu e no Michi	(GameGear)
Ninku Gaiden - Hiroyuki Daikatsugeki	(GameGear)
Nomo Hideo no World Series Baseball	(GameGear)
Olympic Gold 	(GameGear)
Ottifants, The (Europe)	(GameGear)
Out Run	(GameGear)
Pac-Attack	(GameGear)
Pac-In-Time	(GameGear)
Pac-Man	(GameGear)
Panzer Dragoon Mini	(GameGear)
Paperboy	(GameGear)
Paperboy II	(GameGear)
Pengo	(GameGear)
Pengo	(GameGear)
Pet Club Inu Daisuki!	(GameGear)
Pete Sampras Tennis	(GameGear)
Phantasy Star Adventure	(GameGear)
Phantasy Star Gaiden	(GameGear)
Phantom 2040	(GameGear)
Pinball Dreams	(GameGear)
Pocket Jansou	(GameGear)
Pop Breaker	(GameGear)
Popeye no Beach Volleyball	(GameGear)
Power Strike II	(GameGear)
Predator 2	(GameGear)
Primal Rage	(GameGear)
Prince of Persia	(GameGear)
Pro Yakyuu '91, The	(GameGear)
Pro Yakyuu GG League	(GameGear)
Psychic World	(GameGear)
Putt & Putter	(GameGear)
Puyo Puyo	(GameGear)
Puyo Puyo 2	(GameGear)
Puzzle Bobble	(GameGear)
Puzzle and Action Tanto-R	(GameGear)
Quest for the Shaven Yak Starring Ren Hoek & Stimpy	(GameGear)
Quiz Gear Fight!!, The	(GameGear)
R.C. Grand Prix	(GameGear)
Rastan Saga	(GameGear)
Revenge of Drancon	(GameGear)
Rise of the Robots	(GameGear)
Ristar - The Shooting Star	(GameGear)
Road Rash	(GameGear)
RoboCop 3	(GameGear)
RoboCop versus The Terminator	(GameGear)
Royal Stone - Hirakareshi Toki no Tobira	(GameGear)
Ryuukyuu	(GameGear)
S.S. Lucifer - Man Overboard!	(GameGear)
SD Gundam - Winner's History	(GameGear)
Samurai Shodown	(GameGear)
Samurai Spirits	(GameGear)
Scratch Golf	(GameGear)
Sensible Soccer	(GameGear)
Shadam Crusader - Harukanaru Oukoku	(GameGear)
Shanghai II	(GameGear)
Shaq Fu	(GameGear)
Shikinjou	(GameGear)
Shining Force Gaiden - Ensei, Jashin no Kuni e	(GameGear)
Shining Force Gaiden - Final Conflict	(GameGear)
Shining Force Gaiden II - Jashin no Kakusei	(GameGear)
Shining Force II - The Sword of Hajya	(GameGear)
Side Pocket	(GameGear)
Simpsons, The - Bart vs. The Space Mutants	(GameGear)
Simpsons, The - Bart vs. The World	(GameGear)
Skweek	(GameGear)
Slider	(GameGear)
Smurfs, The (Europe)	(GameGear)
Solitaire Funpak	(GameGear)
Solitaire Poker	(GameGear)
Sonic & Tails	(GameGear)
Sonic & Tails 2	(GameGear)
Sonic Blast	(GameGear)
Sonic Chaos	(GameGear)
Sonic Drift	(GameGear)
Sonic Drift 2	(GameGear)
Sonic Labyrinth	(GameGear)
Sonic Spinball	(GameGear)
Sonic The Hedgehog	(GameGear)
Sonic The Hedgehog - Triple Trouble	(GameGear)
Sonic The Hedgehog 2	(GameGear)
Soukoban	(GameGear)
Space Harrier	(GameGear)
Spider-Man - Return of the Sinister Six	(GameGear)
Spider-Man and the X-Men in Arcade's Revenge	(GameGear)
Spider-Man vs. The Kingpin	(GameGear)
Spirou (Europe)	(GameGear)
Star Trek - The Next Generation	(GameGear)
Star Trek Generations - Beyond the Nexus	(GameGear)
Stargate	(GameGear)
Streets of Rage	(GameGear)
Streets of Rage II	(GameGear)
Super Battletank	(GameGear)
Super Columns	(GameGear)
Super Golf	(GameGear)
Super Kick Off	(GameGear)
Super Momotarou Dentetsu III	(GameGear)
Super Monaco GP	(GameGear)
Super Off Road	(GameGear)
Super Return of the Jedi	(GameGear)
Super Smash T.V.	(GameGear)
Super Space Invaders	(GameGear)
Superman - The Man of Steel	(GameGear)
Surf Ninjas	(GameGear)
Sylvan Tale	(GameGear)
T2 - The Arcade Game	(GameGear)
Tails Adventures (Japan, USA)	(GameGear)
Tails no Skypatrol	(GameGear)
Taisen Mahjong HaoPai	(GameGear)
Taisen Mahjong HaoPai 2	(GameGear)
Taisen-gata Daisenryaku G	(GameGear)
Taito Chase H.Q.	(GameGear)
Tale Spin	(GameGear)
Tama & Friends Sanchoume Kouen - Tamalympic	(GameGear)
Tarot no Yakata	(GameGear)
Tarzan - Lord of the Jungle	(GameGear)
Tatakae! Pro Yakyuu Twin League	(GameGear)
Taz in Escape from Mars	(GameGear)
Taz-Mania - The Search for the Lost Seabirds	(GameGear)
Tempo Jr.	(GameGear)
Tengen World Cup Soccer	(GameGear)
Terminator 2 - Judgment Day	(GameGear)
Terminator, The	(GameGear)
Tesserae	(GameGear)
Tintin in Tibet (Europe)	(GameGear)
Tom and Jerry - The Movie	(GameGear)
Torarete Tamaruka	(GameGear)
True Lies	(GameGear)
Urban Strike	(GameGear)
VR Troopers	(GameGear)
Vampire - Master of Darkness	(GameGear)
Virtua Fighter Animation	(GameGear)
Virtua Fighter Mini	(GameGear)
WWF Raw	(GameGear)
WWF Wrestlemania Steel Cage Challenge	(GameGear)
Wagan Land	(GameGear)
Wheel of Fortune	(GameGear)
Wimbledon	(GameGear)
Wizard Pinball	(GameGear)
Wolfchild	(GameGear)
Wonder Boy	(GameGear)
Wonder Boy - The Dragon's Trap	(GameGear)
Wonder Boy III - The Dragon's Trap (USA, Europe)	(GameGear)
Woody Pop	(GameGear)
World Class Leader Board	(GameGear)
World Derby	(GameGear)
X-Men	(GameGear)
X-Men - Gamemaster's Legacy	(GameGear)
X-Men - Mojo World	(GameGear)
Yogi Bear in Yogi Bear's Goldrush	(GameGear)
Yu Yu Hakusho - Horobishimono no Gyakushuu	(GameGear)
Yu Yu Hakusho 2 - Gekitou! Nanakyou no Tatakai	(GameGear)
Zan Gear	(GameGear)
Zool	(GameGear)
Zool no Yume Bouken	(GameGear)
Zoop	(GameGear)
Ankoku Shinwa: Yamato Takeru Densetsu (NES) 
X-men Mutant Academy (GMC) 
Ultimate Mortal Kombat 3 (SMD) 
Super Tennis (SMS) 
Knights of the Round (SNES) 
Fray CD - Xak Gaiden (TG16) 
Jurassic Park III - Park Builder (GBA) 
Cosmic Fantasy 2 (TG16) 
Ultraman: Towards the Future (SNES) 
Hit the Ice (TG16) 
Disney Sports - Motocross (GBA) 
Magic Carpet 2: The Netherworlds (DOS) 
Army Men Advance (GBA) 
Kick Off 3 (DOS) 
xXx (GBA) 
Darklight Conflict [1997] (DOS) 
Star X (GBA) 
MIdwinter II: Flames of Freedom (DOS) 
Dr. Muto (GBA) 
Baal (DOS) 
Xak II: The Rising of the Redmoon (MSX2)